song_name,total_chords,chords_in_key_sig,chords_not_in_key_sig,num_unique_chords,most_frequent_chords,tonic,tonic_frequency
wham_last-christmas,33,33,0,3,iv,Bm,15
a-ha_take-on-me,106,104,2,7,V,A,27
acdc_back-in-black,190,115,75,6,V,D,22
acdc_you-shook-me-all-night-long,108,108,0,3,I,G,47
bon-jovi_livin-on-a-prayer,88,58,30,8,I,C,26
bon-jovi_wanted-dead-or-alive,93,77,16,4,V,C,28
bonnie-tyler_total-eclipse-of-the-heart,123,105,18,10,IV,G#,26
bruce-springsteen_dancing-in-the-dark,72,72,0,5,"vi,I",B,20
bruce-springsteen_the-river,105,105,0,5,I,G,32
bryan-adams_heaven,102,74,28,6,II,F,23
bryan-adams_summer-of-69,46,41,5,7,V,D,14
chris-isaak_wicked-game,46,46,0,3,I,A,20
crowded-house_dont-dream-its-over,74,57,17,7,"I,IV",D#,19
cyndi-lauper_time-after-time,1,1,0,1,I,F,1
dire-straits_romeo-and-juliet,130,130,0,5,V,F,25
elton-john_can-you-feel-the-love-tonight,120,98,22,7,I,D#,39
elton-john_im-still-standing,97,43,54,10,II,D,12
eurythmics_sweet-dreams-are-made-of-this,91,63,28,5,I,G#,32
guns-n-roses_dont-cry,75,75,0,5,V,C,12
guns-n-roses_patience,203,196,7,6,V,F#,30
guns-n-roses_sweet-child-o-mine,148,127,21,7,IV,F#,31
iggy-pop_the-passenger,280,254,26,5,"IV,I",C,78
journey_dont-stop-believin,84,84,0,5,I,E,24
men-at-work_down-under,188,188,0,4,V,D,23
phil-collins_against-all-odds,67,59,8,8,V,C#,6
phil-collins_in-the-air-tonight,70,70,0,3,VII,Dm,16
pixies_hey,33,25,8,5,vi,D,6
pixies_where-is-my-mind,90,62,28,5,"iii,VII",A,20
poison_every-rose-has-its-thorn,72,72,0,4,IV,F#,28
prince_purple-rain,31,31,0,4,"vi,V",A#,6
queen_i-want-to-break-free,42,40,2,5,IV,E,11
queen_under-pressure,82,44,38,5,II,G,27
richard-marx_right-here-waiting,80,80,0,5,"V,vi",C,15
simple-minds_dont-you-forget-about-me,100,75,25,6,I,D,47
sting_englishman-in-new-york,91,89,2,5,VII,Bm,27
survivor_eye-of-the-tiger,164,164,0,6,vi,D#,6
the-cure_just-like-heaven,58,43,15,6,"II,vi",D,9
the-police_every-breath-you-take,32,21,11,8,iii,C#,6
the-proclaimers_im-gonna-be-500-miles,88,88,0,5,I,E,34
the-smiths_please-please-please-let-me-get-what-i-want,29,29,0,4,V,D,8
the-smiths_there-is-a-light-that-never-goes-out,108,108,0,4,V,E,23
tom-petty_free-fallin,145,145,0,3,IV,F,57
tom-petty_i-wont-back-down,125,125,0,4,V,G,40
toto_africa,166,141,25,9,IV,E,19
tracy-chapman_baby-can-i-hold-you,107,107,0,6,I,D,41
tracy-chapman_fast-car,115,115,0,4,vi,A,23
traveling-wilburys_end-of-the-line,87,87,0,3,I,D,51
u2_i-still-havent-found-what-im-looking-for,45,45,0,3,I,C#,23
u2_with-or-without-you,89,89,0,4,"V,vi",D,17
violent-femmes_blister-in-the-sun,125,125,0,4,IV,G,58
abba_gimme-gimme-gimme,90,90,0,6,vi,F,3
air-supply_here-i-am,99,92,7,8,iii,C,13
alain-souchon_la-ballade-de-jim,71,71,0,4,V,D#,15
amy-grant_el-shaddai,95,71,24,8,V,C,13
celine-dion_how-does-a-moment-last-forever,86,80,6,7,I,A#,22
chaka-khan_through-the-fire,82,56,26,9,ii,G,4
culture-club_karma-chameleon,72,72,0,6,V,Bb,15
francis-cabrel_sarbacane,59,57,2,4,I,C,29
george-michael_careless-whisper,57,26,31,3,II,Gm,17
hombres-g_devuelveme-a-mi-chica,39,38,1,6,iii,F,3
jean-jacques-goldman_comme-toi,69,33,36,4,VII,A#,3
jean-jacques-goldman_je-te-donne,170,153,17,7,IV,G,45
jeanette_el-muchacho-de-los-ojos-tristes,65,36,29,9,I,E,13
john-farnham_youre-the-voice,89,53,36,5,V,D#,15
kari-tapio_olen-suomalainen,24,13,11,4,I,E,11
kate-bush_babooshka,110,76,34,7,iv,D#m,8
laura-branigan_self-control,88,88,0,6,iii,A,4
leonard-cohen_im-your-man,42,36,6,8,IV,D,8
marc-lavoine_elle-a-les-yeux-revolver,96,62,34,11,"IV,V",F,8
mike-oldfield_moonlight-shadow,119,119,0,4,V,E,27
modern-talking_youre-my-heart-youre-my-soul,62,62,0,5,"i,VII",C#m,22
nik-kershaw_wouldnt-it-be-good,93,71,22,10,VII,Dm,3
patrick-swayze_shes-like-the-wind,49,49,0,6,vi,G,5
paul-mccartney_mull-of-kintyre,34,34,0,3,IV,D,13
paul-mccartney_say-say-say,36,30,6,5,i,Am,17
paul-young_every-time-you-go-away,47,44,3,7,I,G,15
prince_little-red-corvette,111,111,0,4,IV,C#,13
rod-stewart_forever-young,64,64,0,5,I,E,27
roxette_the-look,74,37,37,6,II,G,22
roxy-music_avalon,71,50,21,6,I,A,36
talking-heads_and-she-was,151,111,40,8,I,A,49
the-alan-parsons-project_old-and-wise,97,40,57,11,v,F,16
the-bangles_eternal-flame,79,66,13,10,vi,G,11
whitney-houston_how-will-i-know,184,137,47,9,I,G,49
wolfgang-petry_wahnsinn,39,39,0,5,"V,I",A,13
grover-washington-jr-_just-the-two-of-us,80,36,44,7,III,G#,16
leonard-cohen_hallelujah,96,92,4,5,IV,C,22
pogues_fairytale-of-new-york,124,124,0,4,I,D,50
shakin-stevens_merry-christmas-everyone,155,104,51,9,IV,E,26
bruce-springsteen_santa-claus-is-coming-to-town,107,101,6,8,I,C,34
abba_slipping-through-my-fingers,112,101,11,7,I,F,36
howard-blake_walking-in-the-air,62,48,14,8,iii,Bb,9
bobby-mcferrin_dont-worry-be-happy,64,64,0,3,V,E,17
morrissey_everyday-is-like-sunday,48,48,0,4,I,C,16
the-smiths_panic,80,58,22,8,vi,G,17
michael-jackson_man-in-the-mirror,147,63,84,13,I,C,26
john-lennon_woman,82,61,21,12,ii,D#,8
queen_another-one-bites-the-dust,52,36,16,7,ii,G#,9
george-strait_amarillo-by-morning,74,53,21,7,IV,E,7
usa-for-africa_we-are-the-world,66,63,3,8,V,E,14
the-judds_beautiful-star-of-bethlehem,51,43,8,4,IV,A,8
alabama_christmas-in-dixie,42,42,0,5,V,D,12
europe_the-final-countdown,131,90,41,9,II,D,28
randy-travis_forever-and-ever-amen,84,72,12,5,"IV,I",D,29
elton-john_sacrifice,93,93,0,6,"IV,V",C#,19
frankie-goes-to-hollywood_the-power-of-love,75,75,0,5,VI,Am,19
michael-jackson_billie-jean,44,44,0,3,iii,D,6
pixies_here-comes-your-man,61,61,0,4,V,D,14
bruce-springsteen_atlantic-city,115,115,0,4,I,G#,52
foreigner_i-want-to-know-what-love-is,77,77,0,5,V,F#,12
traveling-wilburys_handle-with-care,97,91,6,5,IV,G,30
the-cure_lovesong,73,73,0,5,V,C,6
the-smiths_heaven-knows-im-miserable-now,82,67,15,7,I,B,22
pogues_dirty-old-town,52,50,2,7,I,G,16
whitney-houston_i-wanna-dance-with-somebody-who-loves-me,68,59,9,9,IV,F#,9
alphaville_forever-young,101,101,0,5,V,C,11
neil-young_rockin-in-the-free-world,129,128,1,5,IV,G,9
michael-jackson_beat-it,48,48,0,3,VII,D#m,20
eric-clapton_knocking-on-heavens-door,54,54,0,4,V,G,16
metallica_fade-to-black,156,100,56,9,VI,G,26
the-clash_should-i-stay-or-should-i-go,101,94,7,4,IV,D,41
kenny-rogers_islands-in-the-stream,48,15,33,7,bVI,C,8
the-church_under-the-milky-way,81,56,25,4,I,G,27
dire-straits_brothers-in-arms,118,118,0,6,IV,B,13
raffi_wheels-on-the-bus,32,32,0,2,"I,IV",A,16
alannah-myles_black-velvet,62,42,20,8,"vi,III,V",F#,4
dan-fogelberg_leader-of-the-band,156,154,2,7,IV,G,37
the-outfield_your-love,72,68,4,5,V,E,3
joy-division_love-will-tear-us-apart,96,96,0,4,I,D,44
garth-brooks_if-tomorrow-never-comes,93,93,0,6,I,G,25
leonard-cohen_dance-me-to-the-end-of-love,72,56,16,4,i,Gm,37
garth-brooks_the-dance,50,50,0,5,V,G,9
billy-idol_white-wedding,71,71,0,4,ii,A,7
nena_99-luftballons,99,99,0,4,I,E,35
patti-smith_because-the-night,143,100,43,5,iii,G,39
u2_where-the-streets-have-no-name,53,44,9,5,V,G,14
billy-joel_uptown-girl,91,71,20,10,I,E,24
black-uk_wonderful-life,56,56,0,4,vi,G,19
u2_all-i-want-is-you,125,125,0,3,I,C#,63
soft-cell_tainted-love,119,94,25,5,I,A#,33
willie-nelson_pancho-and-lefty,77,77,0,4,IV,D,12
bon-jovi_you-give-love-a-bad-name,71,53,18,5,ii,A#,20
fleetwood-mac_gypsy,120,60,60,8,"I,#II",D,32
george-michael_faith,48,48,0,5,V,E,15
the-beatles_real-love,98,88,10,9,I,D#,24
ozzy-osbourne_crazy-train,156,156,0,5,I,A,55
dire-straits_money-for-nothing,90,61,29,7,vi,Bb,13
reo-speedwagon_cant-fight-this-feeling,94,91,3,7,IV,A,23
roxette_listen-to-your-heart,168,48,120,9,"II,#iv",A,19
abba_happy-new-year,116,93,23,9,I,A,23
cyndi-lauper_girls-just-want-to-have-fun,36,36,0,4,vi,F#,2
tina-turner_the-best,30,23,7,7,ii,C,7
bob-marley_could-you-be-loved,60,60,0,5,vi,D,6
u2_sunday-bloody-sunday,121,116,5,5,I,C#,43
queen_radio-ga-ga,67,67,0,5,IV,F,16
john-mellencamp_hurts-so-good,91,91,0,4,I,A,36
elton-john_i-guess-thats-why-they-call-it-the-blues,128,94,34,8,IV,G,33
inxs_never-tear-us-apart,40,40,0,5,IV,C,13
roxette_it-must-have-been-love,60,52,8,9,I,F,15
alabama_dixieland-delight,125,84,41,11,I,D,26
whitesnake_here-i-go-again,173,173,0,5,V,G,29
madonna_la-isla-bonita,111,106,5,8,V,E,18
bonnie-tyler_holding-out-for-a-hero,65,55,10,7,vi,C,6
hank-williams-jr-_a-country-boy-can-survive,108,94,14,6,V,G,26
vesa-matti-loiri_tonttu,176,176,0,5,vi,G,11
john-lennon_just-like-starting-over,57,48,9,11,V,A,13
don-henley_the-boys-of-summer,43,25,18,5,#VI,C#,17
kim-carnes_bette-davis-eyes,117,117,0,4,IV,F,18
bon-jovi_ill-be-there-for-you,93,66,27,9,I,G,24
rick-springfield_jessies-girl,112,91,21,7,V,D,23
the-alan-parsons-project_eye-in-the-sky,47,39,8,6,vi,D,10
waylon-jennings_luckenbach-texas,42,42,0,4,"V,IV",G,11
gipsy-kings_volare,54,51,3,7,V,E,11
bruce-springsteen_born-in-the-usa,29,29,0,2,I,E,17
the-jam_thats-entertainment,81,81,0,4,VII,Cm,9
cutting-crew_i-just-died-in-your-arms,68,64,4,7,VII,Bm,13
dexys-midnight-runners_come-on-eileen,84,63,21,8,IV,D,9
george-benson_nothings-gonna-change-my-love-for-you,94,57,37,18,IV,C#,12
queen_i-want-it-all,72,50,22,7,I,A,27
madonna_like-a-prayer,106,106,0,6,V,F,20
cyndi-lauper_true-colors,70,70,0,6,I,C,22
bing-crosby_peace-on-earth-little-drummer-boy,89,36,53,9,II,G#,1
yazoo_only-you,77,77,0,4,V,G,21
the-waterboys_fishermans-blues,36,36,0,4,IV,C,5
the-stranglers_golden-brown,202,202,0,6,I,D,57
phil-collins_another-day-in-paradise,98,98,0,5,V,G#,1
indigo-girls_closer-to-fine,182,140,42,4,I,E,90
george-harrison_got-my-mind-set-on-you,137,128,9,5,I,E,49
michael-jackson_human-nature,178,177,1,7,V,D,22
john-lennon_watching-the-wheels,71,63,8,7,IV,C,10
david-bowie_ashes-to-ashes,88,77,11,9,V,C#,8
billy-idol_eyes-without-a-face,41,41,0,5,VII,C#m,5
dolly-parton_9-to-5,39,33,6,4,IV,F#,12
janes-addiction_jane-says,136,67,69,2,#VI,A,67
keith-whitley_when-you-say-nothing-at-all,96,96,0,3,V,D#,17
queen_too-much-love-will-kill-you,96,93,3,6,IV,G,19
keith-whitley_dont-close-your-eyes,71,71,0,5,I,G,23
stevie-nicks_edge-of-seventeen,89,89,0,3,VII,Em,21
fleetwood-mac_everywhere,107,107,0,4,V,E,19
michael-jackson_the-way-you-make-me-feel,197,109,88,5,I,D,89
rufus-chaka-khan_aint-nobody,188,188,0,4,VII,Em,55
the-smiths_this-charming-man,66,64,2,6,V,A,6
david-bowie_lets-dance,63,48,15,7,vi,C#,10
gipsy-kings_bamboleo,49,34,15,5,i,F#m,17
steve-earle_copperhead-road,30,30,0,3,I,G,14
r-e-m-_the-one-i-love,75,75,0,5,vi,G,4
duran-duran_hungry-like-the-wolf,76,40,36,5,VI,G,16
sade_smooth-operator,162,162,0,3,v,Dm,43
guns-n-roses_paradise-city,142,123,19,5,I,C,60
van-halen_jump,46,46,0,5,IV,C,15
michael-jackson_smooth-criminal,31,27,4,5,V,C,1
the-smiths_bigmouth-strikes-again,71,71,0,5,V,B,9
stevie-ray-vaughan-double-trouble_pride-and-joy,45,45,0,3,I,D#,30
freddie-mercury_love-me-like-theres-no-tomorrow,83,35,48,14,"V,v",G,9
kate-bush_running-up-that-hill,154,145,9,8,vi,D#,8
the-cure_a-forest,55,36,19,6,I,C,18
john-mellencamp_jack-and-diane,125,125,0,3,V,A,29
billy-joel_the-longest-time,133,119,14,9,I,D#,59
tears-for-fears_everybody-wants-to-rule-the-world,65,65,0,5,IV,D,4
the-waitresses_christmas-wrapping,170,131,39,9,V,D,34
daniel-johnston_true-love-will-find-you-in-the-end,13,13,0,4,I,C,5
crowded-house_better-be-home-soon,47,40,7,8,I,G,12
twisted-sister_were-not-gonna-take-it,105,67,38,10,V,A,11
katrina-and-the-waves_walking-on-sunshine,176,176,0,3,IV,A#,47
kenny-loggins_footloose,48,40,8,7,I,D#,20
bryan-adams_run-to-you,150,114,36,6,V,A,38
the-cure_pictures-of-you,79,79,0,4,IV,A,34
tears-for-fears_head-over-heels,66,29,37,6,VI,C,18
dan-fogelberg_same-old-lang-syne,93,83,10,7,vi,C,22
bob-marley_buffalo-soldier,69,69,0,5,vi,A,19
john-prine_speed-of-the-sound-of-loneliness,64,64,0,3,I,G,30
pink-floyd_on-the-turning-away,64,64,0,5,IV,G,14
zz-top_sharp-dressed-man,63,42,21,6,V,Bb,9
cat-stevens_if-you-want-to-sing-out-sing-out,129,117,12,10,V,C,29
heart_alone,119,94,25,8,I,F#,38
the-human-league_dont-you-want-me,70,66,4,8,IV,C,2
gin-blossoms_hey-jealousy,112,112,0,4,V,A,4
the-ronettes_sleigh-ride,203,77,126,19,"vi,II",Ab,13
leonard-cohen_everybody-knows,85,54,31,7,iii,A,14
scorpions_send-me-an-angel,110,31,79,10,bV,Gm,3
paul-simon_you-can-call-me-al,144,144,0,3,V,G,32
abba_lay-all-your-love-on-me,136,97,39,6,vi,F,15
journey_open-arms,62,48,14,6,V,G,16
prince_kiss,15,9,6,2,I,D,9
tina-turner_whats-love-got-to-do-with-it,103,62,41,7,I,F#,36
keith-whitley_im-over-you,16,16,0,3,IV,E,6
tom-petty_runnin-down-a-dream,45,31,14,5,IV,D,10
metallica_one,153,76,77,13,"IV,#II,VI",D,11
george-strait_you-look-so-good-in-love,25,25,0,5,V,A,6
john-lennon_beautiful-boy-darling-boy,103,102,1,6,I,D,87
tom-petty-and-the-heartbreakers_the-waiting,108,107,1,5,I,D,41
grateful-dead_althea,126,124,2,6,I,A,52
tears-for-fears_shout,33,17,16,3,II,A#,5
billy-idol_rebel-yell,93,61,32,6,I,D,30
huey-lewis-the-news_the-power-of-love,74,23,51,8,II,Eb,2
gary-valenciano_pasko-na-sinta-ko,62,49,13,8,I,G,17
mecano_hijo-de-la-luna,192,146,46,9,vi,E,22
kool-the-gang_celebration,133,131,2,6,I,C#,60
amy-grant_tennessee-christmas,102,92,10,8,V,A#,18
eagles_seven-bridges-road,34,34,0,3,V,G,9
stan-rogers_northwest-passage,127,127,0,5,IV,D,28
toto_rosanna,104,98,6,8,"V,I",Bb,28
eric-clapton_old-love,70,64,6,6,VII,Am,16
suzanne-vega_luka,92,92,0,4,V,G,7
dire-straits_walk-of-life,81,81,0,3,IV,E,15
echo-the-bunnymen_the-killing-moon,100,63,37,5,I,C,41
hall-oates_out-of-touch,160,155,5,8,V,C,4
whitney-houston_saving-all-my-love-for-you,104,72,32,10,v,E,19
tears-for-fears_mad-world,93,93,0,4,V,G,10
renaud_mistral-gagnant,38,31,7,6,"V,vi",D#,3
pink-floyd_shine-on-you-crazy-diamond,134,114,20,9,vi,Bb,10
cold-chisel_flame-trees,92,87,5,9,I,E,35
chris-de-burgh_lady-in-red,82,76,6,7,V,Bb,10
u2_running-to-stand-still,37,34,3,4,I,G,16
david-bowie_modern-love,60,43,17,7,vi,G,8
cinderella_dont-know-what-you-got-till-its-gone,129,129,0,6,V,A,18
chris-rea_the-road-to-hell,67,55,12,6,vi,C,1
the-smiths_how-soon-is-now,68,46,22,6,"I,VI",A,19
the-smiths_asleep,65,64,1,5,I,G,40
hall-oates_you-make-my-dreams,37,32,5,6,"I,IV",F,10
the-beach-boys_kokomo,64,40,24,7,V,F,12
prince_when-doves-cry,90,90,0,4,VII,Am,13
toto-cutugno_litaliano,41,20,21,8,bvii,C,1
foreigner_waiting-for-a-girl-like-you,60,38,22,8,I,G#,17
the-pretenders_back-on-the-chain-gang,95,60,35,6,I,A,40
stephen-bishop_it-might-be-you,70,60,10,10,IV,G,8
dire-straits_so-far-away,50,50,0,4,V,E,14
kenny-rogers_weve-got-tonight,52,50,2,5,I,G#,34
prince_raspberry-beret,85,82,3,5,IV,D,29
queen_save-me,133,114,19,9,V,G,35
ub40_red-red-wine,69,69,0,3,"IV,V",C#,19
stevie-nicks_leather-and-lace,121,87,34,4,I,G#,44
james-taylor_how-sweet-it-is,83,83,0,5,"I,IV",G,22
reo-speedwagon_take-it-on-the-run,40,40,0,5,V,G,11
the-judds_grandpa-tell-me-bout-the-good-old-days,39,39,0,4,I,E,18
spandau-ballet_true,93,88,5,9,IV,G,20
men-at-work_overkill,78,49,29,6,II,A,17
erasure_a-little-respect,42,37,5,7,IV,C,6
the-cure_in-between-days,38,38,0,4,I,A,17
wham_wake-me-up-before-you-go-go,82,82,0,5,I,C,34
guns-n-roses_used-to-love-her,80,80,0,3,V,D,6
bronski-beat_smalltown-boy,50,50,0,4,"V,I",D,13
ramones_merry-christmas-i-dont-want-to-fight-tonight,75,46,29,6,IV,G,19
billy-bragg_a-new-england,46,46,0,4,"IV,I",G,14
the-blues-brothers_sweet-home-chicago,14,14,0,3,I,E,7
harry-nilsson_everybodys-talking,51,50,1,5,I,E,36
modern-english_i-melt-with-you,56,56,0,5,"IV,I",C,25
boston_amanda,109,107,2,7,V,G,16
billy-joel_movin-out,160,70,90,11,VI,D#,21
hunters-collectors_throw-your-arms-around-me,62,62,0,3,I,E,26
acdc_hells-bells,126,116,10,7,V,G,15
u2_new-years-day,42,42,0,5,vi,C,11
randy-travis_deeper-than-the-holler,67,67,0,5,IV,F,21
bruce-springsteen_glory-days,65,65,0,3,IV,A,25
white-lion_when-the-children-cry,98,98,0,5,vi,G,17
berlin_take-my-breath-away,73,51,22,13,"iii,IV",G#,9
stevie-wonder_lately,76,55,21,12,ii,C#,10
juice-newton_angel-of-the-morning,103,103,0,5,IV,G#,18
whitney-houston_greatest-love-of-all,151,145,6,7,V,A,33
paul-kelly-and-the-coloured-girls_to-her-door,77,77,0,4,V,G,18
journey_separate-ways,105,102,3,6,V,G,4
van-morrison_star-of-the-county-down,122,122,0,4,V,G,21
michael-martin-murphey_maybe-this-time,88,58,30,9,"vi,#VI",G,19
the-cure_lullaby,20,20,0,3,I,A,10
phil-collins_a-groovy-kind-of-love,41,27,14,8,V,G,6
queen_who-wants-to-live-forever,41,38,3,8,"vi,I",G,8
bruce-springsteen_my-hometown,78,78,0,4,V,A,27
morrissey_suedehead,74,59,15,6,I,D,22
r-e-m-_its-the-end-of-the-world-as-we-know-it-and-i-feel-fine,85,80,5,6,I,G,33
billy-joel_its-still-rock-and-roll-to-me,89,64,25,10,iii,C,10
air-supply_all-out-of-love,100,100,0,6,IV,C,16
the-blues-brothers_everybody-needs-somebody-to-love,14,12,2,4,I,F,6
the-pretenders_brass-in-pocket,86,83,3,5,I,A,32
tiffany_i-think-were-alone-now,68,65,3,6,I,D,23
michael-sembello_maniac,17,16,1,4,i,Em,6
randy-travis_i-told-you-so,66,62,4,7,V,A,14
bon-jovi_runaway,48,39,9,7,V,C,5
ub40_kingston-town,66,64,2,7,V,G#,10
talking-heads_this-must-be-the-place-naive-melody,176,176,0,2,ii,D,55
the-cars_drive,38,30,8,6,I,B,17
metallica_for-whom-the-bell-tolls,303,90,213,9,III,C,6
queen_a-kind-of-magic,50,42,8,6,I,A,18
john-mellencamp_small-town,103,103,0,5,V,B,26
scorpions_rock-you-like-a-hurricane,100,55,45,6,VI,G,9
pogues_the-irish-rover,102,102,0,4,I,G,48
depeche-mode_personal-jesus,47,35,12,8,ii,A,8
dio_holy-diver,107,101,6,6,vi,D#,15
crosby-stills-nash_southern-cross,117,117,0,4,IV,D,32
john-hiatt_have-a-little-faith-in-me,148,138,10,7,IV,C,23
alphaville_big-in-japan,117,101,16,6,VI,Dm,11
nena_irgendwie-irgendwo-irgendwann,52,46,6,8,IV,G,10
raffi_baby-beluga,26,26,0,3,I,A,19
david-bowie_as-the-world-falls-down,37,28,9,5,I,A,15
u2_bad,174,174,0,3,I,D,89
eric-clapton_before-you-accuse-me,35,35,0,3,"IV,I",E,15
the-bangles_manic-monday,109,107,2,6,V,D,31
paul-mccartney_uncle-albert-admiral-halsey,107,77,30,11,I,C,36
george-strait_all-my-exs-live-in-texas,63,56,7,7,V,A,5
the-police_every-little-thing-she-does-is-magic,130,65,65,8,III,F,10
bette-midler_wind-beneath-my-wings,58,58,0,5,IV,A#,13
modern-talking_cheri-cheri-lady,67,67,0,5,i,Dm,20
billy-idol_dancing-with-myself,66,66,0,3,IV,E,20
tom-waits_downtown-train,103,103,0,4,IV,D#,28
simply-red_holding-back-the-years,58,31,27,2,I,G,31
pat-benatar_hit-me-with-your-best-shot,109,109,0,4,IV,E,19
rockwell_somebodys-watching-me,99,97,2,5,i,C#m,36
bob-seger-the-silver-bullet-band_fire-lake,74,74,0,6,vi,A,12
rainhard-fendrich_i-am-from-austria,75,75,0,6,V,G,20
guns-n-roses_one-in-a-million,171,96,75,7,V,C,29
phil-collins_you-cant-hurry-love,87,87,0,6,I,G,22
nacha-pop_lucha-de-gigantes,58,56,2,8,V,D,10
metallica_master-of-puppets,231,67,164,14,II,D,30
don-williams_i-believe-in-you,52,52,0,3,I,G,28
bob-dylan_jokerman,147,147,0,6,"V,I",A#,41
the-hooters_johnny-b,132,101,31,8,iii,F,35
the-proclaimers_sunshine-on-leith,46,46,0,4,IV,A#,15
kenny-rogers_lady,70,62,8,7,iii,F,3
talk-talk_its-my-life,95,71,24,10,V,C,15
dead-or-alive_you-spin-me-round-like-a-record,79,53,26,8,vi,A,15
survivor_the-search-is-over,105,81,24,9,V,D#,18
hall-oates_maneater,28,14,14,8,II,G,3
paul-simon_graceland,104,91,13,5,V,A,32
whitney-houston_one-moment-in-time,88,59,29,9,V,A,11
duran-duran_rio,127,68,59,8,VI,Em,11
tesla_love-song,71,67,4,7,V,G,16
joe-cocker_up-where-we-belong,127,45,82,15,III,Eb,12
michael-bolton_how-am-i-supposed-to-live-without-you,77,77,0,5,"iii,I",A#,19
pat-benatar_we-belong,74,74,0,4,IV,F,19
men-at-work_who-can-it-be-now,39,31,8,6,"V,vi",G,6
simply-red_if-you-dont-know-me-by-now,44,36,8,6,IV,A#,6
kinderen-voor-kinderen_niets-is-cooler-dan-kerstmis,99,59,40,14,IV,C#,12
paul-kelly-and-the-coloured-girls_dumb-things,165,150,15,6,vi,C,22
bob-seger-the-silver-bullet-band_like-a-rock,18,18,0,3,I,C#,8
guns-n-roses_welcome-to-the-jungle,60,31,29,11,I,D#,15
australian-crawl_reckless,54,43,11,6,I,G,12
bruce-springsteen_jersey-girl,51,51,0,3,I,D,25
the-cure_close-to-me,17,17,0,4,vi,B,5
the-smiths_stop-me-if-you-think-youve-heard-this-one-before,79,46,33,8,"iii,I",D#,19
acdc_shoot-to-thrill,59,31,28,5,#VI,A,13
randy-travis_pretty-paper,32,28,4,4,IV,A,11
the-rolling-stones_start-me-up,169,155,14,6,I,F,68
eric-clapton_running-on-faith,79,57,22,7,I,D,24
depeche-mode_somebody,37,37,0,5,I,G,9
billy-joel_you-may-be-right,66,61,5,6,I,A,26
pete-townshend_let-my-love-open-the-door,85,85,0,5,V,A,13
tom-waits_time,92,92,0,5,I,D,35
peter-gabriel_in-your-eyes,208,162,46,8,V,A,38
cold-chisel_when-the-war-is-over,84,84,0,6,IV,A,18
cheap-trick_the-flame,98,53,45,5,II,A,29
hall-oates_i-cant-go-for-that-no-can-do,44,23,21,5,v,F,12
hank-williams-jr-_dinosaur,60,56,4,5,I,D,20
edie-brickell-new-bohemians_what-i-am,82,54,28,4,VI,D,26
graham-kendrick_shine-jesus-shine,118,112,6,7,V,G,19
