song_name,total_chords,chords_in_key_sig,chords_not_in_key_sig,num_unique_chords,most_frequent_chords,tonic,tonic_frequency
metallica_nothing-else-matters,106,67,39,6,#VI,D,29
4-non-blondes_whats-up,60,60,0,3,"vi,I,V",D,20
aerosmith_crazy,118,101,17,8,IV,A,18
aerosmith_cryin,150,84,66,12,V,A,20
aerosmith_i-dont-want-to-miss-a-thing,51,48,3,9,V,D,9
alanis-morissette_hand-in-my-pocket,90,80,10,4,I,G,69
alanis-morissette_ironic,99,96,3,5,V,G,25
alanis-morissette_you-oughta-know,58,55,3,5,V,E,6
alice-in-chains_nutshell,44,44,0,4,"vi,I",F#,12
alice-in-chains_rooster,69,30,39,4,VI,A,24
bic-runga_sway,34,34,0,6,"IV,iii",A,4
blind-melon_no-rain,62,33,29,4,II,D,23
blink-182_adams-song,75,75,0,4,I,F,28
blink-182_all-the-small-things,70,70,0,3,V,C,18
blink-182_dammit,70,70,0,4,"V,vi",C,14
blur_coffee-and-tv,106,67,39,10,V,E,13
bob-dylan_make-you-feel-my-love,54,32,22,7,IV,G#,11
bon-jovi_always,109,62,47,8,II,A,32
bon-jovi_bed-of-roses,136,136,0,5,IV,F,39
bonnie-raitt_i-cant-make-you-love-me,96,96,0,5,I,A#,30
bryan-adams_everything-i-do-i-do-it-for-you,46,29,17,7,II,F#,10
bush_glycerine,101,101,0,4,IV,F,22
cake_i-will-survive,107,66,41,7,III,C,15
counting-crows_a-long-december,113,113,0,4,IV,F,32
counting-crows_mr-jones,105,105,0,5,IV,C,14
counting-crows_round-here,102,96,6,6,V,G,19
deep-blue-something_breakfast-at-tiffanys,131,131,0,3,IV,D,40
dexys-midnight-runners_come-on-eileen,84,63,21,8,IV,D,9
duran-duran_ordinary-world,87,58,29,9,I,E,18
eagle-eye-cherry_save-tonight,178,178,0,4,IV,C,46
eagles_love-will-keep-us-alive,49,49,0,6,"vi,IV,V",A,6
edwin-mccain_ill-be,95,66,29,5,I,E,34
elliott-smith_waltz-2-xo,120,109,11,8,I,A#,38
elvis-costello_she,47,33,14,10,I,C,15
eraserheads_ang-huling-el-bimbo,93,73,20,5,I,G,35
eraserheads_with-a-smile,63,45,18,7,ii,G,6
eric-clapton_tears-in-heaven,119,69,50,11,II,D,17
extreme_more-than-words,101,99,2,7,IV,F#,21
faith-no-more_easy,55,46,9,8,"iii,ii",G#,9
fastball_the-way,72,56,16,7,vi,A,12
flogging-molly_if-i-ever-leave-this-world-alive,46,46,0,4,I,D,17
foo-fighters_big-me,53,51,2,5,"IV,I",C,15
foo-fighters_everlong,95,59,36,7,IV,D,20
foo-fighters_learn-to-fly,91,79,12,6,I,E,25
foo-fighters_my-hero,46,44,2,4,I,E,21
fools-garden_lemon-tree,103,95,8,8,iii,G#,6
george-harrison_isnt-it-a-pity,58,54,4,3,I,G,34
goo-goo-dolls_iris,113,113,0,6,IV,C,9
green-day_basket-case,111,108,3,6,V,D#,30
green-day_good-riddance-time-of-your-life,91,91,0,4,I,G,32
green-day_when-i-come-around,96,74,22,5,"I,ii",C#,26
guns-n-roses_knockin-on-heavens-door,44,44,0,4,V,G,12
guns-n-roses_november-rain,78,72,6,10,"ii,IV",B,16
hootie-the-blowfish_hold-my-hand,122,122,0,3,IV,B,50
hootie-the-blowfish_let-her-cry,65,65,0,4,IV,G,21
hootie-the-blowfish_only-wanna-be-with-you,130,130,0,4,IV,F#,54
incubus_drive,47,23,24,3,VI,C,7
jeff-buckley_hallelujah,95,90,5,5,V,C,22
jeff-buckley_lilac-wine,56,31,25,8,V,C,12
joan-osborne_one-of-us,123,123,0,4,IV,A,34
live_lightning-crashes,80,80,0,3,I,B,30
lonestar_amazed,53,39,14,9,IV,C#,7
manu-chao_clandestino,48,30,18,4,v,Bm,8
marc-cohn_walking-in-memphis,183,181,2,6,"V,I",C,52
marcy-playground_sex-and-candy,74,47,27,5,IV,D,7
matchbox-twenty_push,111,111,0,4,V,F#,13
mazzy-star_fade-into-you,70,70,0,4,V,A,21
metallica_the-unforgiven-ii,234,178,56,9,V,C,49
metallica_turn-the-page,68,60,8,4,I,C#,26
metallica_whiskey-in-the-jar,103,103,0,4,I,F,41
michael-jackson_earth-song,174,118,56,9,VI,F#,6
mr-big_to-be-with-you,107,70,37,8,I,E,43
muse_unintended,43,29,14,6,IV,G,7
natalie-imbruglia_torn,57,57,0,5,V,F,11
neil-young_harvest-moon,74,58,16,9,I,D,19
neutral-milk-hotel_in-the-aeroplane-over-the-sea,80,80,0,4,IV,G,19
neutral-milk-hotel_oh-comely,88,60,28,5,VI,G,10
nine-inch-nails_hurt,86,66,20,6,I,D,25
nirvana_come-as-you-are,52,44,8,5,ii,D,12
nirvana_drain-you,135,117,18,8,iii,A,27
nirvana_in-bloom,148,81,67,10,IV,F,9
nirvana_lake-of-fire,47,38,9,6,IV,F,9
nirvana_lithium,229,134,95,7,#V,D,15
nirvana_pennyroyal-tea,64,52,12,5,ii,F#,8
nirvana_polly,150,129,21,5,I,G,42
nirvana_rape-me,122,82,40,8,"I,III",C,30
nirvana_smells-like-teen-spirit,261,132,129,5,V,C#,60
nirvana_something-in-the-way,80,80,0,2,"I,iii",C#,40
nirvana_the-man-who-sold-the-world,44,29,15,5,I,E,14
no-doubt_dont-speak,143,77,66,12,v,D#,16
oasis_cast-no-shadow,49,43,6,5,V,G,10
oasis_champagne-supernova,200,179,21,7,V,D,7
oasis_dont-go-away,78,74,4,7,V,C,4
oasis_dont-look-back-in-anger,141,114,27,6,V,C,27
oasis_half-the-world-away,51,45,6,6,IV,G,4
oasis_live-forever,61,61,0,5,V,G,3
oasis_shes-electric,107,80,27,7,V,A,22
oasis_slide-away,42,29,13,5,I,G,16
oasis_some-might-say,102,96,6,9,IV,D,27
oasis_supersonic,103,89,14,5,I,A,30
oasis_talk-tonight,86,68,18,5,IV,G,18
oasis_whatever,158,126,32,8,I,D,65
oasis_wonderwall,133,118,15,5,vi,A,29
ozzy-osbourne_mama-im-coming-home,79,61,18,9,I,D#,25
parokya-ni-edgar_harana,83,64,19,7,V,G,8
pearl-jam_black,60,38,22,5,I,A,21
pearl-jam_elderly-woman-behind-the-counter-in-a-small-town,90,84,6,4,IV,G,31
pearl-jam_last-kiss,75,75,0,4,"vi,IV,V",G,18
pearl-jam_yellow-ledbetter,33,33,0,3,I,E,13
phil-collins_youll-be-in-my-heart,87,35,52,14,#VI,A#,13
pulp_common-people,27,27,0,3,"I,V",C,13
r-e-m-_everybody-hurts,62,52,10,7,V,G,20
r-e-m-_losing-my-religion,137,131,6,7,IV,C,5
r-e-m-_man-on-the-moon,137,137,0,6,IV,G,26
r-e-m-_shiny-happy-people,135,58,77,8,IV,Bm,4
radiohead_creep,27,13,14,4,"VII,I",F,10
radiohead_exit-music-for-a-film,75,24,51,9,III,G,2
radiohead_fake-plastic-trees,54,54,0,5,I,A,22
radiohead_high-and-dry,69,69,0,3,V,A,20
radiohead_just,92,44,48,10,I,F,18
radiohead_karma-police,132,122,10,9,I,G,39
radiohead_let-down,58,58,0,4,IV,A,18
radiohead_lucky,62,55,7,8,vi,G,8
radiohead_no-surprises,48,42,6,5,V,F,8
radiohead_paranoid-android,58,31,27,13,III,F,5
red-hot-chili-peppers_californication,95,80,15,10,vi,C,12
red-hot-chili-peppers_otherside,89,85,4,6,V,C,18
red-hot-chili-peppers_scar-tissue,38,38,0,3,ii,C,7
red-hot-chili-peppers_under-the-bridge,148,100,48,12,IV,E,20
rivermaya_214,108,95,13,8,IV,G,14
rivermaya_kisapmata,105,105,0,4,"ii,V",D,22
robbie-williams_shes-the-one,76,76,0,5,IV,A#,17
rusted-root_send-me-on-my-way,85,85,0,4,IV,C,21
scorpions_wind-of-change,118,116,2,6,V,C,17
semisonic_closing-time,185,178,7,8,"V,ii",G,40
sheryl-crow_if-it-makes-you-happy,35,35,0,4,I,G,18
sister-hazel_all-for-you,152,140,12,6,V,G#,15
sixpence-none-the-richer_kiss-me,63,63,0,4,I,D#,31
smash-mouth_all-star,121,101,20,5,I,B,45
sonicflood_i-could-sing-of-your-love-forever,20,20,0,5,I,G,6
sonicflood_open-the-eyes-of-my-heart,17,17,0,5,"V,I",G,5
soundgarden_black-hole-sun,112,53,59,9,III,A#,22
sting_fields-of-gold,77,77,0,4,IV,D,21
sting_shape-of-my-heart,116,69,47,9,VI,E,1
stone-temple-pilots_creep,53,45,8,5,iii,C,11
sublime_badfish,50,50,0,4,V,D,11
sublime_santeria,75,55,20,6,"ii,I",B,19
sublime_what-i-got,89,89,0,2,I,G,46
tenacious-d_tribute,84,61,23,7,ii,G,20
the-black-crowes_she-talks-to-angels,28,28,0,3,IV,E,8
the-cardigans_lovefool,117,59,58,10,VI,G,8
the-connells_74-75,95,95,0,4,I,C,35
the-cranberries_dreams,54,48,6,5,I,E,20
the-cranberries_ode-to-my-family,88,88,0,4,I,D,26
the-cranberries_zombie,59,59,0,4,V,G,19
the-cure_friday-im-in-love,70,57,13,5,V,G,18
the-dubliners_the-fields-of-athenry,83,83,0,4,I,E,32
the-las_there-she-goes,86,86,0,5,I,G,29
the-offspring_self-esteem,197,163,34,6,I,F,54
the-offspring_the-kids-arent-alright,32,32,0,4,"IV,I",C#,10
the-pretenders_ill-stand-by-you,73,62,11,9,iii,G,15
the-smashing-pumpkins_1979,51,49,2,6,I,D#,17
the-smashing-pumpkins_disarm,78,78,0,4,V,G,10
the-smashing-pumpkins_today,89,51,38,7,#VI,A#,22
the-smashing-pumpkins_tonight-tonight,89,89,0,5,I,F#,23
the-tragically-hip_bobcaygeon,65,65,0,6,I,G,24
the-verve_bitter-sweet-symphony,196,196,0,4,"ii,IV",A,46
the-verve_lucky-man,70,70,0,3,I,D,44
the-verve_the-drugs-dont-work,91,91,0,5,I,C,47
the-wallflowers_one-headlight,107,86,21,6,I,D,24
third-eye-blind_hows-it-going-to-be,73,73,0,4,V,F,21
third-eye-blind_jumper,41,41,0,4,I,G,20
third-eye-blind_semi-charmed-life,170,170,0,4,V,G,35
tom-petty_you-dont-know-how-it-feels,140,134,6,4,I,A,59
tom-petty-and-the-heartbreakers_learning-to-fly,162,162,0,4,"I,vi",C,47
tom-petty-and-the-heartbreakers_mary-janes-last-dance,79,73,6,5,ii,G,21
tonic_if-you-could-only-see,73,71,2,6,V,C#,17
u2_one,59,59,0,4,IV,G,5
weezer_buddy-holly,104,81,23,7,IV,D#,22
weezer_say-it-aint-so,116,81,35,6,"III,IV",D#,23
weezer_undone-the-sweater-song,65,65,0,3,IV,G,13
alain-souchon_foule-sentimentale,291,223,68,5,iv,Em,67
backstreet-boys_i-want-it-that-way,94,66,28,7,I,E,19
bonnie-raitt_something-to-talk-about,40,24,16,9,II,C#,6
britney-spears_baby-one-more-time,82,55,27,6,III,D#,16
celine-dion_all-by-myself,177,56,121,22,VI,A,22
celine-dion_beauty-and-the-beast,35,33,2,6,IV,G,5
celine-dion_because-you-loved-me,56,33,23,13,I,G#,12
celine-dion_my-heart-will-go-on,89,66,23,8,V,E,10
celine-dion_pour-que-tu-maimes-encore,89,61,28,10,I,D,17
celine-dion_the-prayer,68,51,17,13,I,F,16
cher_believe,77,77,0,6,IV,C,15
christina-aguilera_reflection,85,63,22,12,V,G,11
destinys-child_say-my-name,131,131,0,4,iv,Cm,28
dido_thank-you,88,86,2,8,IV,B,27
francis-cabrel_la-corrida,86,76,10,6,V,F,21
guus-meeuwis-vagant_het-is-een-nacht-levensecht,103,103,0,4,V,G,25
haddaway_what-is-love,102,102,0,4,"I,iii",C,26
hanson_mmmbop,34,34,0,3,V,A,8
henry-valentino_im-wagen-vor-mir,101,101,0,5,IV,C,21
luis-miguel_historia-de-un-amor,29,23,6,6,vi,C,2
mariah-carey_all-i-want-for-christmas-is-you,84,62,22,9,I,G,20
mariah-carey_when-you-believe,85,47,38,12,II,A,13
michael-jackson_heal-the-world,119,99,20,15,ii,A,14
michael-jackson_you-are-not-alone,63,31,32,15,v,F#,8
phil-collins_son-of-man,65,47,18,7,I,A,20
robbie-williams_angels,56,48,8,6,I,C,19
rod-stewart_have-i-told-you-lately,56,56,0,4,iii,C,6
ronan-keating_when-you-say-nothing-at-all,113,74,39,8,I,D,53
savage-garden_i-knew-i-loved-you,132,101,31,12,IV,A,17
savage-garden_truly-madly-deeply,57,57,0,4,V,C,8
spice-girls_wannabe,136,98,38,7,I,E,35
sting_its-probably-me,58,52,6,8,vi,G,6
take-that_back-for-good,107,107,0,5,"I,ii",F,26
the-corrs_runaway,103,103,0,5,"ii,IV",D,22
tlc_no-scrubs,63,46,17,4,I,E,18
toni-braxton_un-break-my-heart,80,43,37,7,VII,Bm,7
u2_stay-faraway-so-close,75,58,17,5,I,D#,26
van-morrison_days-like-this,131,131,0,5,I,D#,41
westlife_more-than-words,95,93,2,6,I,F#,24
wet-wet-wet_love-is-all-around,117,117,0,4,IV,A#,24
whitney-houston_i-have-nothing,104,47,57,20,I,C,12
whitney-houston_i-will-always-love-you,55,39,16,9,ii,E,10
fugees_killing-me-softly,54,54,0,5,V,G,12
randy-newman_youve-got-a-friend-in-me,92,63,29,11,I,D#,32
elliott-smith_between-the-bars,52,43,9,6,IV,A#,8
shania-twain_youre-still-the-one,68,68,0,4,IV,D#,19
barenaked-ladies_god-rest-ye-merry-gentlemen,174,117,57,6,vi,F,21
seal_kiss-from-a-rose,103,53,50,6,I,F,41
the-wiggles_jingle-bells,30,28,2,4,I,D,12
metallica_the-unforgiven,161,149,12,6,ii,G,31
garth-brooks_friends-in-low-places,59,56,3,4,V,A,19
elliott-smith_say-yes,60,54,6,7,"I,vi",F,19
brooks-dunn_neon-moon,47,47,0,3,I,A,21
the-highwaymen_highwayman,116,116,0,5,V,D,13
depeche-mode_enjoy-the-silence,30,26,4,5,I,G#,12
hillsong-worship_king-of-kings,94,94,0,4,I,D,33
soul-asylum_runaway-train,56,56,0,5,"iii,vi",C,10
eva-cassidy_fields-of-gold,84,84,0,4,IV,A,19
coolio_gangstas-paradise,124,89,35,4,"vi,VII",Ab,27
metallica_enter-sandman,120,85,35,6,V,B,20
dolly-parton_hard-candy-christmas,102,79,23,8,IV,C#,15
bob-dylan_mama-you-been-on-my-mind,63,51,12,6,I,F,27
paul-kelly_how-to-make-gravy,94,94,0,5,ii,E,17
billy-ray-cyrus_achy-breaky-heart,18,18,0,2,I,E,11
red-hot-chili-peppers_soul-to-squeeze,130,130,0,6,"V,vi",F,26
matt-redman_the-heart-of-worship,74,74,0,4,V,D#,24
fiona-apple_paper-bag,113,84,29,7,V,C,12
dumdum-boys_stjernesludd,58,55,3,6,I,C#,19
vanessa-williams_colors-of-the-wind,60,60,0,6,vi,A#,6
coldplay_dont-panic,17,17,0,4,ii,C,4
john-prine_in-spite-of-ourselves,56,56,0,3,I,C,28
hillsong-worship_o-holy-night,112,112,0,6,V,G,27
nirvana_oh-me,58,39,19,4,V,F#,6
blackstreet_no-diggity,83,64,19,4,I,D#,23
pavement_harness-your-hopes,86,70,16,7,IV,E,12
garth-brooks_the-thunder-rolls,100,82,18,4,i,Dm,35
lenny-kravitz_fly-away,39,24,15,5,"III,IV,I",G,9
acdc_thunderstruck,123,122,1,4,IV,E,42
my-bloody-valentine_when-you-sleep,21,21,0,4,VI,D#m,3
tom-petty-and-the-heartbreakers_christmas-all-over-again,87,83,4,7,"vi,ii",A,21
jewel_you-were-meant-for-me,97,97,0,4,IV,G,24
tom-petty-and-the-heartbreakers_into-the-great-wide-open,114,105,9,7,vi,G,31
stuart-townend_how-deep-the-fathers-love-for-us,75,75,0,5,I,E,33
fugazi_im-so-tired,47,35,12,4,"VII,iii,I",C,12
alamid_your-love,137,136,1,6,V,G,31
elliott-smith_angeles,85,76,9,8,IV,G,4
blink-182_whats-my-age-again,102,102,0,4,V,F#,27
the-band_atlantic-city,168,168,0,4,I,A,82
alanis-morissette_head-over-feet,118,84,34,8,I,G,27
jamiroquai_virtual-insanity,82,54,28,7,i,Ebm,24
bryan-adams_please-forgive-me,116,87,29,9,IV,E,24
dr-dre_still-dre,188,188,0,2,i,Bbm,140
alan-jackson_theres-a-new-kid-in-town,70,66,4,7,"IV,I",E,20
tlc_waterfalls,78,54,24,4,"II,IV",G,15
tom-petty_you-wreck-me,182,155,27,6,I,A#,60
mariah-carey_o-holy-night,93,58,35,13,V,A,6
iron-maiden_fear-of-the-dark,144,144,0,4,V,F,10
blur_song-2,122,122,0,6,I,G#,28
vince-vance-the-valiants_all-i-want-for-christmas-is-you,99,59,40,16,I,A,17
ween_ocean-man,23,23,0,3,V,E,5
elliott-smith_needle-in-the-hay,117,99,18,5,IV,C,19
pearl-jam_alive,119,54,65,7,I,G,41
ariel-rivera_sana-ngayong-pasko,60,60,0,4,I,C,27
blind-melon_change,117,117,0,3,V,D,33
kenny-wayne-shepherd_blue-on-black,118,81,37,5,I,C,40
red-hot-chili-peppers_my-friends,108,82,26,7,I,D,48
green-day_brain-stew,104,41,63,5,"#II,II,#I,I",D#,21
the-black-crowes_hard-to-handle,63,49,14,5,I,B,31
macy-gray_i-try,57,36,21,11,ii,D,4
hillsong-worship_the-power-of-your-love,72,72,0,5,I,G,21
red-hot-chili-peppers_road-trippin,103,76,27,7,IV,G,8
mercyme_i-can-only-imagine,60,60,0,3,I,E,36
everlast_what-its-like,113,107,6,3,ii,C,39
pearl-jam_better-man,82,72,10,5,I,D,27
green-day_she,58,58,0,3,"IV,I",F#,24
dixie-chicks_cowboy-take-me-away,168,168,0,4,V,F#,39
the-verve_sonnet,36,36,0,5,V,C,2
the-kelly-family_an-angel,63,63,0,5,V,C,19
lucky-ali_o-sanam,58,39,19,4,I,D,22
deana-carter_strawberry-wine,61,61,0,5,I,C#,18
metallica_mama-said,203,165,38,8,ii,B,46
hole_violet,95,52,43,7,I,C,26
nirvana_lounge-act,143,87,56,9,IV,D,19
bryan-adams_when-youre-gone,80,63,17,5,V,F,10
oasis_all-around-the-world,79,27,52,11,#VI,F#,11
buena-vista-social-club_chan-chan,81,69,12,5,"I,V,ii",F,19
blind-guardian_the-bards-song-in-the-forest,105,105,0,6,vi,C,10
the-cranberries_animal-instinct,77,77,0,5,IV,G,1
pearl-jam_daughter,79,79,0,2,I,G,58
eva-cassidy_songbird,36,36,0,5,IV,G,10
guns-n-roses_civil-war,114,99,15,9,I,G,32
jan-smit_o-dennenboom,81,81,0,5,I,E,32
red-hot-chili-peppers_breaking-the-girl,80,62,18,7,I,G,20
eraserheads_pare-ko,128,128,0,5,IV,G,30
david-gray_this-years-love,72,47,25,5,I,D#,26
blue-rodeo_hasnt-hit-me-yet,117,105,12,5,I,E,34
alain-bashung_la-nuit-je-mens,78,78,0,5,VI,Bm,11
robbie-williams_let-me-entertain-you,69,47,22,3,V,A#,22
def-leppard_two-steps-behind,98,85,13,5,I,D,48
spin-doctors_two-princes,155,155,0,4,V,D,35
placebo_every-you-every-me,70,48,22,5,IV,F,9
travis-tritt_anymore,59,54,5,6,V,B,3
john-anderson_seminole-wind,69,69,0,4,"IV,I",D,20
creed_with-arms-wide-open,57,48,9,7,I,C,23
vince-gill_let-there-be-peace-on-earth,51,38,13,9,vi,C,8
fernando-ortega_give-me-jesus,42,42,0,4,IV,C#,6
misfits_saturday-night,67,44,23,9,I,G#,17
everclear_santa-monica,69,63,6,4,I,G,35
bruce-springsteen_streets-of-philadelphia,29,29,0,5,I,F,11
mariah-carey_santa-claus-is-comin-to-town,115,100,15,8,I,G,45
sarah-mclachlan_angel,72,72,0,5,I,C,30
mariah-carey_without-you,38,32,6,7,"ii,vi",F#,7
bloodhound-gang_fire-water-burn,55,36,19,7,I,G,22
r-kelly_i-believe-i-can-fly,30,18,12,5,iv,C,10
ace-of-base_the-sign,86,80,6,6,IV,G,17
ben-harper_burn-one-down,36,36,0,4,vi,G,6
david-lee-murphy_dust-on-the-bottle,98,98,0,4,IV,B,18
brooks-dunn_boot-scootin-boogie,93,89,4,5,I,E,43
neutral-milk-hotel_holland-1945,94,89,5,4,IV,G,33
blues-traveler_hook,176,153,23,5,IV,A,43
pearl-jam_nothingman,87,87,0,4,IV,F,11
the-cranberries_just-my-imagination,53,53,0,4,V,A#,7
marilyn-manson_sweet-dreams-are-made-of-this,87,55,32,3,#I,G,29
eva-cassidy_over-the-rainbow,67,66,1,7,"V,I",G#,15
john-williams_home-alone-theme-somewhere-in-my-memory,28,26,2,7,ii,D,7
tevin-campbell_can-we-talk,62,37,25,9,III,F,1
eve-6_inside-out,114,89,25,5,I,E,35
christy-moore_black-is-the-colour,63,51,12,4,VII,Am,7
harvey-danger_flagpole-sitta,52,37,15,6,I,C,27
urge-overkill_girl-youll-be-a-woman-soon,37,34,3,5,ii,F,15
portishead_glory-box,75,53,22,2,i,D#m,53
weezer_pink-triangle,160,160,0,6,I,F#,43
jeff-buckley_grace,121,81,40,12,ii,D,10
michael-learns-to-rock_thats-why-you-go-away,86,74,12,11,V,G,17
nick-cave-the-bad-seeds_red-right-hand,25,5,20,4,iv,F#,5
shania-twain_from-this-moment-on,55,28,27,12,I,D,13
new-radicals_you-get-what-you-give,94,94,0,4,VII,Bm,11
rick-price_heaven-knows,117,117,0,6,IV,C,24
portishead_roads,33,28,5,4,VII,Am,10
silverchair_tomorrow,126,96,30,5,V,G,10
the-kelly-family_fell-in-love-with-an-alien,131,131,0,6,vi,D#,15
stone-temple-pilots_plush,118,80,38,6,I,G,28
massive-attack_teardrop,55,46,9,4,V,D,9
celine-dion_o-holy-night,68,66,2,7,I,G,28
garth-brooks_the-river,76,71,5,7,I,D,30
alice-in-chains_man-in-the-box,75,75,0,4,I,C#,22
my-bloody-valentine_sometimes,45,41,4,5,vi,G,4
mike-the-mechanics_over-my-shoulder,93,56,37,9,VI,C#,8
seal_crazy,68,43,25,7,II,G,18
blondie_maria,102,102,0,4,IV,A,16
nsync_merry-christmas-happy-holidays,109,109,0,5,V,F,23
nirvana_plateau,89,89,0,3,I,A,35
hole_doll-parts,47,29,18,2,I,G,29
the-magnetic-fields_the-book-of-love,102,102,0,3,I,G,44
bruce-springsteen_the-ghost-of-tom-joad,73,73,0,4,vi,C,18
the-wonders_that-thing-you-do,86,49,37,9,V,A,16
concrete-blonde_joey,62,62,0,4,I,G,21
oasis_hello,50,49,1,5,ii,G,6
jewel_who-will-save-your-soul,92,92,0,4,I,G,27
mariah-carey_fantasy,111,111,0,4,vi,C,1
john-mayer_no-such-thing,18,5,13,5,i,A,3
george-strait_check-yes-or-no,155,155,0,4,V,F,39
slowdive_alison,20,18,2,3,"I,IV",B,9
tom-waits_hold-on,85,85,0,4,I,D,29
belle-and-sebastian_get-me-away-from-here-im-dying,85,82,3,6,IV,F#,17
nick-cave-the-bad-seeds_where-the-wild-roses-grow,87,71,16,5,vi,A#,16
rednex_cotton-eye-joe,46,26,20,4,#VI,E,10
don-moen_i-offer-my-life,49,49,0,5,IV,G,10
alan-jackson_livin-on-love,56,56,0,3,I,A,27
alison-krauss_when-you-say-nothing-at-all,109,109,0,3,V,D,18
radiohead_black-star,102,97,5,7,I,G,35
collective-soul_the-world-i-know,84,81,3,5,V,D,25
the-kelly-family_i-cant-help-myself,52,52,0,4,IV,C#,10
barenaked-ladies_brian-wilson,115,112,3,6,vi,A#,18
ub40_i-cant-help-falling-in-love-with-you,110,101,9,6,V,D,25
madonna_frozen,137,101,36,8,ii,D#,16
george-strait_write-this-down,68,54,14,4,V,G#,22
blues-traveler_run-around,284,284,0,4,"IV,ii",G,67
neil-young_unknown-legend,38,38,0,2,I,G,21
meredith-brooks_bitch,65,65,0,5,V,A,10
parokya-ni-edgar_halaga,147,147,0,4,V,D,35
the-tragically-hip_wheat-kings,96,96,0,3,IV,G,44
wilco_how-to-fight-loneliness,37,32,5,6,V,D,2
don-moen_god-will-make-a-way,79,48,31,11,I,A,24
eraserheads_magasin,72,47,25,5,"VII,iii",F,11
tal-bachman_shes-so-high,83,83,0,4,IV,A,23
toby-keith_shouldve-been-a-cowboy,171,171,0,3,V,G,40
grant-lee-buffalo_fuzzy,18,18,0,3,i,Fm,9
crowded-house_fall-at-your-feet,60,53,7,6,vi,D#,15
crowded-house_weather-with-you,26,10,16,4,VI,C,5
pearl-jam_even-flow,116,51,65,4,II,C,45
